16 16
11 70
15 14 19 19  19 19 13 15  16 15 12 12  12 12 12 12
15 10 19 19  19 19 9  12  12 10 19 19  19 19 19 19  
14 23 19 19  19 19 19 19  19 19 19 19  19 19 19 19    
15 11 11 11  11 11 11 11  11 8  20 20  20 19 19 19  
  
15 15 15 15  15 15 15 15  15 15 11 11  8  23 19 19  
15 16 15 15  15 15 15 12  12 12 12 12  14 23 19 19  
12 12 12 12  15 16 14 19  19 19 19 19  3  23 19 19    
11 11 11 8   9  12 10 19  19 19 19 19  19 19 19 19  
  
15 12 12 14  19 19 19 19  19 19 19 19  19 19 19 19  
14 19 19 6   19 19 19 19  19 19 19 19  19 19 19 19    
14 19 2  10  19 19 19 19  19 19 19 19  19 19 19 19  
14 19 19 19  19 19 19 19  19 19 19 19  19 19 19 19  
  
14 19 19 19  19 19 19 19  19 19 19 19  19 19 19 19  
14 19 19 19  19 19 19 19  19 19 19 19  19 19 19 19    
14 19 19 19  19 19 19 19  19 19 19 19  19 19 19 19  
14 19 19 19  19 19 19 19  19 19 19 19  19 19 19 19  


0 

4
33 78
57 54
117 46
117 14