16 16
0 88
10 19 19 19  9  12 12 12  15 12 12 12  12 12 15 12  
22 19 19 19  22 22 22 22  6  22 22 22  22 6  22 22
19 19 19 19  19 19 19 19  3  19 19 19  19 3  19 19 
19 19 19 19  19 19 19 19  22 19 19 19  19 22 19 19
  
19 19 19 19  19 19 19 19  19 19 19 19  19 19 19 19
19 19 19 19  19 20 19 19  19 19 19 20  19 19 19 19  
19 19 19 19  21 0  23 19  19 19 21 0   23 19 19 19
19 19 19 19  19 22 19 19  19 19 19 22  19 19 19 19  
  
19 19 19 19  19 19 19 19  19 19 19 19  19 19 19 19  
19 19 19 19  19 19 19 19  19 19 19 19  20 19 19 19  
19 19 19 19  19 19 19 19  19 19 19 21  4  23 19 19  
19 19 19 19  19 19 19 19  19 19 19 21  6  23 19 19  
  
19 19 19 19  19 20 20 20  20 19 19 21  3  23 19 19  
11 11 8  20  20 7  5  5   1  19 19 19  19 19 19 19  
15 15 15 11  11 14 19 19  19 19 19 19  19 19 19 19  
15 15 15 15  15 14 19 19  19 19 7  11  11 11 11 8  


0

5
16 6
16 32
64 40
112 40
112 68