16 16
6 88
15 15 12 10  19 19 19 19  9  12 12 12  12 15 15 15  
15 14 19 19  19 19 19 19  19 19 19 19  19 13 15 15  
15 14 19 19  19 19 19 19  19 19 19 19  19 19 13 15  
15 14 19 19  19 19 19 19  19 19 19 19  19 19  9 15  

15 14 1  19  19 19 19 19  19 19 19 19  19 19 19 13  
15 12 5  5   5  1  19 19  19 19 19 19  19 19 19 13  
15 15 14 5   5  5  1  19  19 19 19 19  19 19 19 13
16 15 14 19  19 19 19 19  19 19 19 19  19 19 19 13

15 15 14 19  19 19 19 19  19 19 19 19  19 19 19 13  
15 16 10 19  19 19 19 19  19 19 19 19  19 19 19 13 
12 10 19 19  19 19 19 19  19 7 11 11   11 11 11 15    
19 19 19 19  19 19 19 19  19 9  12 15  15 15 15 15  

19 19 19 19  19 19 19 19  19 19 19 13  15 15 15 15  
19 19 19 19  19 20 19 19  19 19 19 13  15 16 15 15 
11 11 11 11  11 8  19 19  19 19 19 13  15 15 15 15 
11 11 11 11  11 14 19 19  19 19 19 13  15 15 16 15   


0

0