16 16
1 110
19 19 19 19  19 19 19 19  19 19 19 19  19 19 19 19  
19 19 19 19  19 19 19 19  19 19 19 19  19 19 19 19     
19 19 19 19  19 19 19 19  19 19 19 19  19 19 19 19  
19 19 19 19  19 19 19 19  19 19 19 19  19 19 19 19  

19 19 19 19  19 19 19 25  19 19 19 19  19 19 19 19  
19 19 19 19  19 19 19 19  19 19 19 19  19 19 19 19     
19 19 19 19  19 19 19 19  19 19 19 19  19 19 19 19  
19 19 19 19  19 19 19 7   11 8  19 19  19 19 19 19  
  
19 19 19 19  19 19 7  15  15 14 19 19  19 19 19 19  
19 19 19 19  19 19 13 16  15 15 8  19  19 19 19 19     
19 19 19 19  19 7  15 15  15 15 14 19  19 19 19 19  
19 19 19 19  19 13 15 15  15 16 14 19  19 19 19 19  
  
19 19 19 19  19 9  12 15  15 12 12 1   19 19 19 19  
19 19 7  11  11 11 8  9   10 7  11 8   19 19 19 19     
19 19 9  15  15 16 15 11  11 15 15 15  8  19 19 19  
7  11 8  13  15 15 15 15  15 15 16 15  15 11 11 8   

0

0