16 16
0 88
19 19 19 19  19 19 19 19  21 6  19 19  9  12 12 15  
19 19 19 19  19 19 19 20  20 6  19 19  19 19 19 13    
19 19 19 19  19 19 21 2   5  10 19 19  19 19 19 9   
19 19 19 19  19 19 19 19  21 2  5  8   19 19 19 22  
  
20 19 19 19  19 19 19 19  19 19 19 3   19 19 19 20  
4  19 19 19  19 19 19 19  19 19 19 22  19 19 19 7     
3  19 19 19  20 19 19 19  19 19 19 20  19 19 19 9   
22 19 19 19  4  20 19 19  19 19 21 4   19 19 19 22  
  
20 19 19 19  3  4  19 19  19 19 21 3   19 19 19 20  
4  19 19 19  22 6  19 19  19 19 19 22  19 19 19 7     
3  19 19 19  20 6  19 19  19 19 19 20  19 19 19 9   
22 19 19 19  4  6  19 19  19 19 19 4   19 19 19 22  
  
19 19 19 19  3  6  19 19  19 19 19 3   19 19 19 20  
19 19 19 19  22 6  19 19  19 19 19 19  19 19 19 7     
19 19 19 19  19 3  19 19  19 19 19 19  19 19 19 9  
8  19 19 19  19 19 19 19  19 19 19 19  19 19 19 22  


0 

0