16 16
0 88
15 15 16 14  19 19 19 19  9  12 12 12  12 12 15 16  
12 12 12 10  19 19 19 19  19 19 19 19  19 0  9  15  
19 19 19 19  19 19 19 19  19 19 19 19  19 19 19 9   
19 19 19 19  19 19 19 24  19 19 19 19  19 19 19 19  
  
19 19 19 20  20 19 19 0   19 19 19 19  19 19 19 19  
19 19 21 7   8  19 19 19  19 19 20 19  19 19 19 19  
19 19 21 9   10 20 20 20  20 20 4  19  19 19 19 21  
19 19 21 2   5  5  5  5   5  1  6  19  19 19 19 7   
  
19 19 21 0   22 22 22 22  22 22 6  19  19 19 19 9   
19 19 19 22  19 19 19 19  19 19 6  19  19 19 19 21  
19 19 19 19  19 19 19 20  19 19 3  19  19 19 19 19  
19 19 19 20  19 19 19 4   19 19 22 19  19 19 19 19  
  
19 19 19 4   19 19 19 6   19 19 19 19  19 19 19 19  
7  8  19 6   19 19 19 6   19 19 19 19  19 19 19 19  
9  10 19 6   19 24 19 6   19 19 19 19  19 19 19 19  
8  19 19 6   19 0  19 6   19 19 19 19  19 19 19 19  


0

1
112 32