16 16
5 40
19 19 19 19  19 19 19 19  19 19 19 19  19 9  12 15  
19 19 19 19  19 19 20 19  19 19 19 19  19 19 19 9     
19 19 19 19  19 21 0  23  19 24 19 19  19 19 19 19  
19 19 19 20  19 19 22 19  21 0  23 19  19 19 19 19  

19 19 21 0   23 19 19 19  19 22 19 19  19 19 19 19  
19 19 19 22  19 19 19 20  19 19 19 19  19 19 19 19    
19 19 19 19  19 19 21 0   23 19 19 19  19 19 19 19  
19 19 19 19  19 19 19 22  19 19 19 19  19 19 19 19  
  
19 4  20 20  20 20 20 20  20 20 20 20  20 20 19 19
19 6  2  5   5  5  5  5   5  5  5  5   5  1  23 19    
19 3  19 19  19 19 19 0   19 19 19 19  19 4  23 19  
19 22 19 19  19 19 19 22  19 19 19 19  19 3  23 19  
  
19 19 19 19  19 19 19 19  19 19 19 19  19 19 19 19  
19 19 19 19  19 19 19 19  19 19 19 19  19 19 19 19    
19 19 19 19  19 19 19 19  19 19 19 19  19 19 19 19  
19 19 19 19  19 19 19 19  19 19 19 19  19 19 19 19  


0

6
32 100
80 100
112 104
120 64
88 48
112 24