16 16
6 88
15 15 10 19  19 19 9  12  12 12 12 12  12 15 15 15  
15 14 19 19  19 19 19 19  19 19 19 19  19 13 15 15  
15 14 19 19  19 19 19 19  19 19 19 19  19 13 15 15
15 14 19 19  19 19 19 19  19 19 19 19  19 13 15 15 

15 14 0  19  19 19 19 19  19 19 19 19  19 13 15 15 
15 12 5  11  11 8  19 19  19 19 19 19  19 13 15 15 
16 15 14 12  12 12 2  5   5  1  19 19  19 13 15 15
15 15 14 10  19 19 22 22  22 22 19 19  19 13 15 15

15 15 14 19  19 19 19 19  19 19 19 19  19 13 15 15
15 16 10 19  19 19 19 19  19 19 19 19  19 13 15 15
12 10 19 19  19 19 20 20  20 20 19 19  19 13 15 15   
19 19 19 19  19 19 2  5   5  1  19 19  19 13 15 15 

19 19 19 19  19 19 19 19  19 19 19 19  19 13 15 15 
19 19 19 19  24 19 19 19  19 19 19 19  19 13 15 15
11 11 11 11  8  19 19 19  19 19 19 19  24 13 15 15
11 11 11 11  14 19 19 19  19 19 19 19  7  11 11 15


0

0