16 16
6 88
15 15 15 15  15 15 15 15  15 15 15 15  14 19 19 13  
15 15 15 15  15 15 15 15  15 15 15 15  14 19 19 13
15 15 15 15  15 15 15 15  15 15 15 15  14 19 19 13
15 15 15 15  15 15 15 15  15 15 15 15  14 19 19 13  

15 12 12 12  12 12 12 12  12 12 12 12  10 19 19 13
14 19 19 19  19 19 19 19  19 19 19 19  19 19 19 13
14 19 19 19  19 19 19 19  19 19 19 19  19 19 19 13
14 19 19 19  19 19 19 19  19 19 19 19  7  11  11 13

14 19 19 19  19 19 19 19  19 19 19 19  9  11 12 13
14 19 19 19  19 19 19 19  19 19 19 19  19 19 19 13
14 19 19 19  19 19 19 19  19 19 19 19  19 19 19 13
14 19 19 19  19 19 19 19  19 19 19 19  19 19 19 13


14 19 19 19  19 19 19 19  19 19 19 19  19 19 19 13
14 19 19 19  19 19 19 19  19 19 19 19  19 19 19 13
14 19 19 19  19 19 19 19  19 19 19 19  19 19 19 13
15 11 11 11  11 11 11 8   19 19 19 7   11 11 11 15    


0

1
75 70