16 16
0 88
19 19 19 19  19 19 19 19  19 13 15 15  15 15 16 15  
19 19 19 19  19 19 19 19  19 9  12 15  15 15 15 15  
19 19 19 19  19 19 19 19  19 19 19 13  15 16 15 15  
19 19 19 19  19 19 19 19  19 19 19 13  15 15 15 16  
  
19 19 19 19  19 19 19 19  19 19 19 13  16 15 15 15  
19 19 19 19  19 19 19 19  19 19 19 9   12 12 12 12  
19 19 19 19  19 19 19 19  19 19 19 22  22 22 22 22  
19 19 19 20  20 20 20 19  19 19 19 19  19 19 19 19  
  
19 19 19 7   11 11 8  19  0  19 19 19  19 19 19 19  
19 19 19 9   12 15 15 11  5  5  5  1   19 19 19 19  
19 19 19 19  19 9  12 14  22 22 22 22  19 19 19 19  
19 19 19 19  19 19 21 6   19 19 19 19  19 24 19 19  
  
19 19 19 19  19 19 21 3   19 19 19 19  19 2  19 19  
19 19 19 19  19 19 19 19  19 19 19 19  19 6  19 19  
7  11 11 11  8  23 19 19  19 24 19 19  19 6  19 19  
9  15 15 15  14 23 19 19  19 4  19 19  19 6  19 19  


0

0