16 16
6 100
15 15 15 15  15 15 15 15  12 12 12 14  19 19 19 13  
15 15 15 15  15 15 15 15  15 15 15 14  19 19 19 13  
15 15 15 15  15 12 12 12  12 12 15 14  19 19 19 13  
15 15 15 15  10 19 19 19  19 19  9 14  19 19 19 13  

15 15 15 14  19 19 19 19  19 19 19 6   19 19 19 13  
15 15 16 14  19 19 19 19  19 19 19 6   19 19 19 13  
15 15 16 14  19 19 19 20  19 19 19 6   19 19 19 13  
16 15 15 14  19 19 19 4   19 19 19 6   19 19 19 13  

15 15 15 14  19 19 19 6   19 19 19 6   19 19 19 13  
15 16 15 14  19 19 19 6   19 19 19 6   19 19 19 13  
15 15 15 14  19 19 19 6   19 19 19 3   19 19 19 13  
15 12 12 10  19 19 19 6   19 19 19 19  19 19 19 13  

14 19 19 19  19 19 19 6   19 19 19 19  19 19 19 13  
14 19 19 19  19 19 19 6   19 19 19 19  19 19 19 13  
14 19 19 19  19 19 19 6   20 20 19 19  19 19 19 13   
15 11 11 11  11 11 11 15  11 11 11 11  11 11 11 15   


0 

0