16 16
20 18
19 19 19 19 19   19 19 19 19 19 19 19 19 19 19 19
19 19 19 19 19 19 19 19 19 19 19 19 19 19 19 19
19 19 19 19 19 19 19 19 19 19 19 19 19 19 19 19
19 19 19 19 19 19 19 19 19 19 19 19 19 19 19 19
14 19 19 19 19 19 19 19 19 19 19 19 14 19 19 13
14 19 19 19 19 19 19 19 19 19 19 19 14 19 19 13
14 19 19 19 19 19 19 19 19 19 19 19 14 19 19 13
14 19 19 19 19 19 19 19 19 19 19 19 14 19 19 13
14 19 19 19 19 19 19 19 19 19 19 19 14 19 19 13
14 5 5 5 5 1 19 19 19 19 19 19 19 19 19 13
14 19 19 19 19 19 19 19 19 19 19 19 19 19 19 13
11 11 11 11 11 11 19 11 11 11 11 11 11 11 11 11
0 0 0 0 0 0 19 0 0 19 0 0 0 0 0 0
19 19 19 19 19 19 19 19 19 19 19 19 19 19 19 19
11 11 11 11 11 11 19 11 11 11 11 11 11 11 11 11
19 19 19 19 19 19 19 19 19 19 19 19 19 19 19 19
0 0 0 0 0 0 0 0
0 0 0 0 0 0 0 0
0 0 0 0 0 0 0 0
0 0 0 0 0 0 0 0
0 0 0 0 0 0 0 0
0 0 0 0 0 0 0 0
0 0 0 0 0 0 0 0
0 0 0 0 0 0 0 0